10 14
1 1 1 0 0 0 0 0 1 1 1 1 1 1
1 9 1 0 0 1 0 0 1 1 1 1 3 1
1 1 1 0 0 0 0 0 1 1 1 1 0 0
0 0 0 0 0 0 0 0 0 1 1 1 0 0
0 0 0 0 0 0 0 0 0 0 0 1 1 0
0 0 0 0 0 0 0 0 0 0 0 0 1 0
0 0 0 0 0 0 0 0 0 0 0 0 1 0
0 0 0 0 0 0 0 0 0 0 0 1 1 0
0 0 0 0 1 1 1 1 1 0 0 1 1 0
0 0 0 0 1 6 0 0 1 1 1 4 1 0
10 9
2
13 9
10 9
2
4 9
5 9
4
13 7
13 8
7 9
8 9