10 12
0 1 1 1 1 0 0 0 0 0 0 0
0 1 9 1 1 0 0 0 0 0 0 0
0 1 1 1 0 0 0 0 0 0 0 0
0 1 0 0 0 1 1 1 1 1 1 0
0 1 0 0 0 1 1 0 0 1 1 0
1 1 1 1 1 1 1 0 0 1 1 1
0 0 0 0 0 1 8 0 0 0 0 1
0 0 0 0 0 1 1 1 1 0 0 1
0 0 0 0 0 1 1 1 1 1 1 1
0 0 0 0 0 0 0 0 1 1 1 0
1 5
2
5 9
5 10