10 13
0 0 0 0 0 0 0 0 0 0 0 0 4
0 0 0 0 0 1 1 1 0 0 1 1 1
0 0 0 0 0 1 4 1 1 1 1 1 0
0 0 0 1 1 1 1 1 0 0 1 1 0
0 0 0 1 9 1 0 0 0 0 1 1 0
0 1 1 1 1 1 0 0 0 1 1 1 1
1 1 1 1 0 0 0 0 0 1 1 1 1
1 1 1 1 0 0 1 1 1 1 1 0 0
0 0 0 0 0 1 1 1 0 0 0 0 0
0 0 0 0 0 1 1 1 0 0 0 0 0
3 4
1
7 6
1
13 8