10 14
0 0 0 0 0 0 0 0 1 1 1 0 0 0
0 0 0 1 1 1 0 0 1 1 1 0 0 0
1 0 0 1 1 1 1 1 1 1 1 1 1 1
1 0 0 1 1 1 0 0 0 0 0 0 4 1
1 0 0 0 0 0 0 0 0 0 0 0 1 1
1 0 0 0 0 0 0 0 0 0 0 0 1 1
1 0 0 0 0 0 0 0 1 1 1 1 1 1
1 1 1 1 1 0 0 0 1 1 1 0 0 0
0 1 1 9 1 0 0 0 1 1 1 0 0 0
0 0 1 1 1 0 0 0 1 1 1 1 1 4
5 8
2
2 8
3 8
2
2 7
3 7