10 15
0 0 0 0 0 0 0 1 1 1 0 0 1 1 1
0 0 0 0 1 1 1 1 1 1 0 0 4 1 1
1 1 0 0 1 0 0 1 1 1 0 0 1 1 1
1 1 1 1 1 0 0 0 6 0 0 0 0 0 0
1 1 0 0 0 0 0 0 0 0 0 0 0 0 0
0 1 0 0 0 0 0 3 0 0 0 0 0 0 0
0 1 0 0 0 0 0 1 0 0 0 0 0 0 0
1 1 1 0 0 0 1 1 1 0 0 8 1 1 0
1 1 1 1 1 1 1 1 1 1 1 1 9 1 0
1 1 1 0 0 0 1 1 1 0 0 8 1 1 0
2 2
4
6 9
7 9
3 8
4 8
4
6 9
7 9
11 9
12 9
2
14 9
2 2
2
10 2
11 2
2
10 2
11 2