7 13
0 3 0 0 0 0 0 0 0 0 1 1 1
3 1 3 0 0 5 5 1 0 0 1 9 1
0 3 0 0 0 0 0 0 0 0 1 1 1
0 0 0 0 0 0 0 0 0 0 0 0 0
0 0 1 1 1 0 0 0 1 1 1 0 0
0 0 1 1 1 1 1 1 1 3 1 0 0
0 0 1 1 1 0 0 0 1 1 1 0 0
4 2
2
8 6
6 6
2
3 6
2 7
2
1 6
3 6
2
4 6
5 6
2
9 6
10 6
2
2 5
1 6
2
2 7
1 6