9 15
0 0 0 0 0 0 0 7 0 0 0 0 0 0 0
1 1 8 1 0 0 0 1 0 0 0 0 0 0 0
1 1 1 1 1 0 0 1 0 0 0 0 0 0 0
1 8 1 1 1 1 1 1 0 0 1 1 0 0 1
1 1 1 1 1 0 0 0 1 0 0 0 1 0 0
1 1 8 1 0 0 0 0 1 0 0 0 1 0 0
1 0 0 0 0 0 0 0 7 0 0 1 1 1 0
1 0 0 0 0 0 0 0 0 0 1 1 9 1 0
1 0 0 4 0 0 0 0 0 0 1 1 1 1 0
3 6
2
9 6
10 6
4
2 1
3 1
13 6
14 6
2
9 6
10 6
4
2 1
3 1
13 6
14 6
4
2 1
3 1
13 6
14 6
1
6 5