10 15
0 1 1 1 1 1 1 1 1 1 6 1 1 1 1
0 0 0 0 0 1 1 0 0 0 0 0 0 1 1
0 0 0 0 0 1 1 0 0 0 0 0 0 1 1
0 0 0 0 0 0 0 0 0 0 0 0 0 1 1
0 0 0 0 0 0 0 0 0 0 0 0 0 1 1
1 1 1 0 0 1 1 0 0 1 8 1 1 1 1
1 9 1 0 0 1 1 0 0 0 0 0 0 0 0
1 1 1 0 0 1 1 0 0 0 0 0 0 0 0
0 1 1 0 0 1 1 0 0 0 0 0 0 0 0
0 1 1 1 1 1 1 1 1 1 7 1 1 1 0
2 10
2
8 5
9 5
2
3 1
4 1
2
3 1
4 1