6 15
0 0 0 0 0 0 1 1 1 1 0 0 1 1 1
1 1 1 1 0 0 1 1 4 1 0 0 1 9 1
1 1 6 1 0 0 1 1 1 1 0 0 1 1 1
1 1 1 1 0 0 1 1 1 1 0 0 1 1 1
1 1 1 1 0 0 1 1 1 1 0 0 1 1 1
1 1 1 1 0 0 1 1 1 1 0 0 0 0 0
2 2
2
11 2
12 2
2
5 2
6 2