10 15
0 0 0 0 0 0 0 0 0 0 0 0 1 1 1
0 0 1 1 1 1 1 1 1 1 0 0 1 1 1
0 0 1 1 1 0 0 8 1 1 0 0 1 1 1
0 0 1 1 1 0 0 1 1 1 0 0 0 0 0
0 0 1 8 1 0 0 3 1 8 0 0 0 0 0
0 0 1 1 1 0 0 1 1 1 0 0 0 0 0
1 1 1 1 0 0 0 1 1 1 0 0 6 1 1
1 6 0 0 0 0 0 0 0 0 0 0 1 1 1
0 0 0 0 0 0 0 0 0 0 0 0 1 9 1
0 0 0 0 0 0 0 0 0 0 0 0 1 1 1
9 8
2
6 9
7 9
2
6 9
7 9
2
14 9
14 3
2
6 9
7 9
2
11 4
12 4
2
11 9
12 9