10 15
0 0 0 0 0 0 0 0 1 1 0 0 0 0 0
0 0 0 0 0 0 0 1 1 1 0 0 0 0 0
1 1 0 0 1 1 1 1 1 1 0 0 0 0 0
1 1 1 1 1 1 0 0 1 0 0 0 0 0 0
1 1 1 1 0 0 0 0 1 0 0 0 1 1 1
0 1 1 0 0 0 0 0 4 1 1 1 1 9 1
0 0 1 0 0 0 0 0 4 1 0 0 1 1 1
0 0 1 1 1 0 0 0 1 1 0 0 0 0 0
0 0 0 1 1 1 0 0 1 1 0 0 0 0 0
0 0 0 0 1 1 1 1 1 1 0 0 0 0 0
2 7
1
4 1
1
6 3