10 14
0 0 0 0 0 1 1 0 0 0 0 1 1 1
0 0 0 1 1 1 1 1 1 0 0 1 9 1
1 1 1 1 1 1 8 1 1 1 1 1 1 1
1 1 1 1 8 0 0 1 1 1 1 1 0 0
1 1 1 0 0 0 0 0 0 1 1 1 0 0
0 1 0 0 0 0 0 0 0 0 1 0 0 0
0 1 0 0 0 0 0 0 0 0 1 0 0 0
0 1 0 0 0 0 0 0 0 1 1 0 0 0
0 1 1 0 0 0 0 0 0 1 1 0 0 0
0 0 4 0 0 0 0 0 0 4 0 0 0 0
2 7
2
3 3
13 7
2
3 3
13 7
1
13 7
1
3 3