8 14
0 0 0 0 0 0 0 0 0 0 1 1 1 1
0 0 0 0 1 1 1 1 1 1 1 5 1 3
0 1 0 0 1 5 1 0 0 0 1 1 1 1
5 1 0 0 1 1 0 0 0 0 0 0 1 0
1 1 0 0 1 0 0 0 0 0 0 0 1 0
1 1 1 1 1 0 0 0 0 0 1 1 1 0
1 1 1 0 0 1 1 1 0 0 1 9 1 0
0 0 0 0 0 5 1 0 0 0 1 1 1 0
1 5
2
3 6
4 6
2
6 2
8 2
1
8 1
1
4 7
2
9 2
10 2