9 14
0 0 0 0 0 1 1 1 1 0 0 0 0 3
0 0 0 0 0 1 1 8 1 1 1 0 0 1
0 0 0 0 1 1 1 1 1 1 1 0 0 1
1 1 1 1 1 1 1 1 0 0 1 1 1 1
1 1 1 0 0 0 1 0 0 0 1 1 0 0
1 1 1 0 0 0 1 0 0 0 1 0 0 0
0 1 0 0 0 0 1 1 1 0 0 0 0 0
0 5 0 0 0 0 1 9 1 0 0 0 0 0
0 0 0 0 0 0 1 1 1 0 0 0 0 0
11 4
2
13 6
11 4
2
3 6
4 6
2
4 5
10 2