10 15
1 1 1 0 0 0 0 1 1 1 1 1 1 1 1
1 1 1 1 1 1 1 1 1 1 1 0 0 1 1
1 1 1 0 0 0 0 1 1 0 0 0 0 1 1
0 0 0 0 0 0 0 0 0 0 0 0 1 10 1
0 0 0 0 0 0 0 0 0 0 0 0 1 1 0
1 1 1 0 0 2 2 2 2 1 0 0 8 8 0
1 9 1 2 2 2 2 2 2 2 0 0 1 1 1
1 1 1 2 2 2 2 2 2 2 2 2 1 1 1
0 0 0 0 0 2 2 2 2 2 2 2 1 1 1
0 0 0 0 0 0 1 1 1 1 0 0 0 0 0
2 9
2
7 1
10 1
1
7 1
1
10 1