10 15
0 1 1 1 1 1 1 0 0 0 0 0 0 0 0
0 1 1 0 0 1 1 1 0 0 0 0 0 0 0
2 2 1 0 0 1 1 1 1 0 0 0 0 0 0
2 2 0 0 0 0 0 1 1 1 0 0 0 0 0
2 2 0 0 0 0 0 0 1 1 1 0 0 0 0
2 1 1 1 0 0 0 0 0 1 1 3 0 0 0
0 1 9 1 0 0 0 0 0 0 1 1 1 1 1
0 1 1 1 1 1 1 0 0 0 1 8 1 1 1
0 0 1 0 0 1 1 0 0 0 1 1 1 0 0
0 0 1 0 0 1 1 1 1 1 1 1 1 0 0
3 8
2
15 4
13 1
4
4 10
5 10
9 1
10 1