9 14
0 0 0 0 0 0 0 0 0 0 0 0 1 4
0 0 1 1 1 1 1 1 0 0 0 1 1 1
0 1 1 1 0 0 1 1 0 0 1 4 1 1
0 1 9 1 0 0 0 1 1 1 1 1 0 0
0 1 1 1 0 0 0 0 1 1 1 0 0 0
0 0 0 0 0 0 0 0 0 1 1 0 0 0
0 0 0 0 1 1 1 0 0 1 1 0 0 0
1 1 0 0 1 4 1 0 0 1 1 0 0 0
1 1 0 0 1 1 1 1 1 1 1 0 0 0
11 3
4
5 8
6 8
3 2
4 2
2
3 1
4 1
2
5 7
6 7