10 15
0 0 0 0 0 1 1 8 1 1 1 0 0 0 0
0 0 0 0 0 1 1 1 1 1 1 0 0 0 0
1 1 1 0 0 8 1 1 8 1 1 1 1 1 0
1 1 1 1 1 1 1 1 1 8 8 1 1 8 0
0 0 0 0 0 1 1 8 1 1 8 1 1 1 0
0 0 0 0 0 1 1 1 1 1 1 8 1 1 0
1 1 1 0 0 1 1 1 1 1 1 8 1 1 1
1 9 1 1 1 1 8 1 0 0 1 1 1 8 5
1 1 1 0 0 1 1 1 0 0 0 1 1 1 1
1 1 1 0 0 0 0 0 0 0 0 0 1 1 1
2 7
2
4 3
5 3
2
4 3
5 3
2
4 3
5 3
2
4 3
5 3
2
4 3
5 3
2
4 3
5 3
2
4 3
5 3
2
4 3
5 3
2
4 3
5 3
2
4 3
5 3
2
4 3
5 3
2
4 3
5 3
1
12 9