10 15
0 0 0 0 0 0 0 0 0 0 0 1 1 1 1
0 1 1 1 1 1 1 1 6 1 1 1 1 1 1
0 1 1 1 1 0 0 0 0 0 0 0 1 1 1
0 1 1 7 1 0 0 0 0 0 0 0 0 0 0
0 1 1 1 1 0 0 0 0 0 0 0 0 0 0
0 0 0 1 1 1 8 1 1 1 1 1 1 0 0
0 0 0 0 0 0 0 0 0 0 1 1 1 1 6
1 1 1 0 0 0 0 0 0 0 1 1 1 1 1
1 9 1 1 1 1 1 1 1 1 1 1 1 0 0
1 1 1 1 0 0 0 0 0 0 0 0 0 0 0
14 9
2
6 9
7 9
2
6 2
7 2
2
6 2
7 2
2
6 2
7 2