8 15
0 0 0 0 0 0 0 0 1 1 1 1 0 0 0
0 0 0 0 0 0 0 0 1 1 1 1 0 0 0
1 1 1 0 0 0 0 0 1 0 0 1 1 1 1
1 1 1 1 1 1 1 1 1 0 0 0 1 9 1
1 1 1 0 0 0 0 1 1 5 0 0 1 1 1
1 1 1 0 0 0 0 1 1 1 0 0 1 1 1
0 1 1 0 0 0 0 1 0 0 0 0 0 0 0
0 0 1 1 1 1 1 1 0 0 0 0 0 0 0
2 5
1
4 2