5 15
1 1 1 1 0 0 0 1 0 0 0 1 1 1 1
1 1 1 1 0 0 0 1 0 0 0 1 1 3 1
1 1 1 1 1 1 1 1 1 1 1 1 1 1 1
0 0 0 0 0 0 1 9 1 0 0 0 0 0 0
0 0 0 0 0 0 1 1 1 0 0 0 0 0 0
2 4
2
13 4
3 4